1 15 25
2 2 2 2 2 2 2 2 2 2 2 2 2 2 2 2 2 2 2 2 2 2 2 2 2
2 2 2 2 2 2 2 2 2 2 2 2 2 2 2 2 2 2 2 2 2 2 2 2 2
2 0 0 1 8 0 0 4 0 0 1 0 0 4 0 0 1 0 0 0 0 1 0 0 2
2 0 2 1 2 0 2 1 2 1 2 0 2 0 2 0 2 1 2 0 2 0 2 1 2
2 0 1 1 0 0 1 0 0 7 0 0 0 0 4 0 0 1 0 1 0 6 1 0 2
2 1 2 0 2 0 2 1 2 0 2 0 2 0 2 1 2 0 2 0 2 0 2 0 2
2 0 0 0 0 1 0 0 1 2 0 5 0 0 0 1 0 2 0 1 1 0 0 1 2
2 0 2 1 2 1 2 0 2 0 2 0 1 0 2 1 2 0 2 0 2 1 2 0 2
2 0 0 0 4 0 0 0 0 0 0 2 0 0 0 0 4 0 0 0 0 1 0 0 2
2 0 2 1 2 1 2 0 2 0 2 0 2 0 2 1 2 1 2 0 2 1 2 0 2
2 1 1 0 1 0 0 1 1 0 0 0 1 0 0 0 1 1 1 0 1 0 1 0 2
2 0 2 1 2 0 2 1 2 0 2 0 2 1 2 1 2 0 2 1 2 0 2 1 2
2 0 0 1 1 1 0 1 0 9 2 1 0 0 2 0 1 0 1 1 0 0 1 0 2
2 0 1 0 0 0 1 0 1 1 0 2 0 0 1 0 0 1 0 0 0 1 0 3 2
2 2 2 2 2 2 2 2 2 2 2 2 2 2 2 2 2 2 2 2 2 2 2 2 2