1 15 25
2 2 2 2 2 2 2 2 2 2 2 2 2 2 2 2 2 2 2 2 2 2 2 2 2
2 0 0 0 3 0 0 0 0 0 6 0 0 0 3 0 0 0 3 0 0 0 0 0 2
2 0 0 3 1 3 1 0 1 3 1 3 1 0 1 0 0 0 1 0 1 3 1 3 2
2 0 3 0 0 0 3 0 3 0 0 0 3 0 3 3 0 0 3 0 3 0 0 0 2
2 0 1 0 0 0 1 0 1 0 0 0 1 0 1 3 1 0 1 0 1 0 0 0 2
2 0 3 0 0 0 3 0 3 0 0 0 3 0 3 0 3 0 3 0 3 0 0 0 2
2 0 1 0 0 3 1 0 1 0 0 0 1 0 1 0 1 0 1 0 1 0 0 0 2
2 0 0 3 3 0 0 0 3 0 0 0 3 0 3 0 3 0 3 0 0 0 0 0 2
2 0 1 0 0 3 1 0 1 0 0 0 1 0 1 0 1 0 1 0 1 3 1 3 2
2 0 3 0 0 0 3 0 0 0 0 0 3 0 0 0 3 0 0 0 3 0 0 0 2
2 0 1 0 0 0 1 0 1 0 0 0 1 0 1 0 1 3 1 0 1 0 0 0 2
2 0 3 0 0 0 3 0 7 0 0 0 3 0 3 0 0 3 3 0 3 0 0 0 2
2 0 1 3 1 3 1 0 1 3 1 3 1 0 1 0 0 0 1 0 1 3 1 3 2
2 0 0 0 3 0 0 0 0 0 3 0 0 0 3 0 0 0 3 0 0 0 0 0 2
2 2 2 2 2 2 2 2 2 2 2 2 2 2 2 2 2 2 2 2 2 2 2 2 2